25 25 20 20 

7 7 7 7 7 7 7 7 7 7 7 7 7 7 7 7 7 7 7 7  
7 0 0 0 0 7 7 3 0 0 0 0 0 0 0 0 0 0 0 7
7 0 0 0 0 7 7 7 0 0 0 0 0 0 0 0 0 0 0 7
7 2 2 2 2 7 7 4 0 0 0 0 0 0 0 0 0 0 0 7
7 0 0 0 0 7 7 7 7 7 7 7 7 7 7 0 0 0 0 7
7 0 0 0 0 7 7 7 7 7 7 7 7 7 7 0 0 0 0 7
7 0 0 0 0 7 7 7 7 7 7 7 7 7 7 0 0 0 0 7
7 0 0 0 0 7 7 7 7 7 7 7 7 7 7 0 0 0 0 7
7 0 0 0 0 7 7 7 7 7 7 7 7 7 7 0 0 0 0 7
7 0 0 0 0 7 7 7 7 7 7 7 7 7 7 0 0 0 0 7
7 0 0 0 0 7 7 7 7 7 7 7 7 7 7 0 0 0 0 7
7 0 0 0 0 0 0 0 0 0 0 0 0 0 0 0 0 0 0 7
7 0 0 0 0 0 0 0 0 0 0 0 0 0 0 0 0 0 0 7
7 0 0 0 0 0 0 0 0 0 0 0 0 0 0 0 0 0 0 7
7 0 0 0 0 0 0 0 0 0 0 0 0 0 0 0 0 0 0 7
7 0 0 0 0 0 0 0 0 0 0 0 0 0 0 0 0 0 0 7
7 0 0 0 0 0 0 0 0 0 0 0 0 0 0 0 0 0 0 7  
7 0 0 0 7 7 7 0 0 0 0 0 0 7 0 0 0 0 0 7 
7 0 0 0 0 0 0 0 0 0 0 0 0 0 0 0 0 0 0 7
7 7 7 7 7 7 7 7 7 7 7 7 7 7 7 7 7 7 7 7
 
 



